10
8
0001001000
1101111100
1001000111
1000010001
1101111101
0100100101
0111110111
00001j0000